

NO textures/grey.xpm
EA textures/wood.xpm
SO textures/brick.xpm
WE textures/grey.xpm

F 34,13,3
C 2,153,25




       11111111111111111111111111
       10000000001111000000000011111
       10110000000110000000000011
       10010000000000001000000011111111111
1111011111100101110000001111
11110111100001101110101001
111101111000011011101010011111111111111111
11110111100001101110101001
11110111100S01101110101001111
111101111000011011101010011
1111011110000110110101001
1111011110000110111010100111
11110111100001101110101001
111111111111111111111111
11111111111111111111111111
111111111111111111111111111
