F 34,13,3


NO textures/grey.xpm
EA textures/wood.xpm
C 2,153,25
SO textures/brick.xpm
WE textures/grey.xpm


          11111111111111111111111
          111111111111000000000111
          101100000111000000000011111111111
1111111111100000000001111111111111
111111111111000001110000000000001
100000000011000001110111111111111
11110111111111011100000010001
11110111111111011101010010001
11000000110101011100000010001
10000000000000001100000010001
10000000000000001101010010001
11000001110101011111011110N0111
11110111 1110101 101111010001
11111111 1111111 111111111111   1111111111111111111111
                                1000000000000000100011
                                1111111111111111 11111