F 34,13,3


NO textures/grey.xpm
EA textures/wood.xpm
C 2,153,25
SO textures/brick.xpm
WE textures/grey.xpm





       11111111111111 1111111111111     
       10000000001111000000000011111
       10110000000110000000000011
       1001000000000000100011111111111
1111111111100101110000001111
1111011100001101110101001
11110111100001101110100011111111111111111
11110111100001101110101001
1111011110001101110101001111
111101111000011011101010011
1111011110000110110101001
111101111000110111010100111
111101W1100001101110101001
1111111111 1111111111111111