F 34,13,1
C 2,25,255

WE textures/black.xpm
NO textures/grey.xpm
EA textures/wood.xpm
SO textures/brick.xpm


          111111111 1111111111111
          111111111111000000111
          1011000001110000001
11111111111000000001 11111111
11111111111100000111100000001
10000000001100000111011111111
11110111111111011100000010001
11110111111111011101010010001
11000000110101011100000010001
10000000000000001100000010001
10000000000000011010100100001
11000001110101011111011110N01
11110111 1110101 101111010001
11111111 1111111 111111111111